1st_week: '1ère semaine'
24h_performance: 'Performance 24h / 24'
2nd_week: '2ème semaine'
3rd_week: '3ème semaine'
4th_week: '4e semaine'
5th_week: '5e semaine'
API_Documentation: 'Documentation API'
April: Avril
August: Août
Automation: Automatisation
Automations: Automatisation
B: B
Bounce: Rebond
CAMPAIGNS: Campagnes
Cancel: Annuler
Click: Cliquez sur
Copy: Copie
Copy_paste_onto_your_site: 'Copiez / collez sur votre site'
DELETE: SUPPRIMER
December: Décembre
Embedded_form: 'Forme intégrée'
Endpoint: Point final
February: Février
Friday: Vendredi
Function: Fonction
GET: OBTENIR
HTTP_method: 'Méthode HTTP'
January: Janvier
July: Juillet
June: Juin
LISTS: LISTES
March: Mars
May: Peut
Monday: Lundi
'No': 'Non'
November: Novembre
October: Octobre
Open: Ouvrir
PATCH: CORRECTIF
POST: Poste
SENDING_SERVER: 'Serveur d'envoi'
SUBSCRIBERS: LES ABONNÉS
Saturday: Samedi
September: Septembre
Subscribe_to_our_mailing_list: 'Abonnez-vous à notre liste de diffusion'
Sunday: Dimanche
Thursday: Jeudi
Tuesday: Mardi
URL: URL
Wednesday: Mercredi
abuse_reports: 'Rapports d'abus'
access_when_offline: 'Accès lorsque le site est hors ligne'
account: Compte
account.color_scheme: 'Choisissez les couleurs de votre compte'
account.color_scheme.into: 'Personnalisez votre panneau de compte avec des couleurs.Sélectionnez une de couleur ci-dessous, vous souhaitez personnaliser votre compte'
account.menu_layout: 'Disposition du menu'
account.menu_layout.into: 'Sélectionnez le menu L'une des dispositions de menu ci-dessus que vous aimez.La disposition du menu vous aide plus facile à parcourir les pages d'application en fonction de votre style de préférence'
account.personality: Personnalité
account.welcome_user: 'Bienvenue à nouveau,: nom!'
action: Action
action_when_email_exist: 'Choisissez l'action lorsque le courrier électronique existe dans la liste cible'
actions: Actions
activated: Activé
activation_email_resent_content: '<p> Veuillez cliquer sur le lien dans l'e-mail que nous venons de vous envoyer. </p>'
activation_email_sent_content: '<p> Nous devons confirmer votre adresse e-mail pour terminer le processus d'enregistrement.Pour terminer le processus d'inscription, veuillez cliquer sur le lien dans l'e-mail que nous venons de vous envoyer. </p>'
activation_email_sent_title: 'Confirmation d'enregistrement'
